NO assets/sprites/north_wall.xpm
SO assets/sprites/south_wall.xpm
EA assets/sprites/east_wall.xpm
WE assets/sprites/west_wall.xpm

F 64,64,64
C 0,0,0


  11111111111
  10000000001
  10111111101
  101     101
  101     101
  10111111101
  10000000001
  11111011111
      101        
111111101111
100100000001
100100000001
100000000001
100100S0000111
10010000000001
11111111111111